11111111111111111111111111111
1C010000000100000000001000001
10000000000100001000001000001
1100CCC000010000C100001000001
10000000000000001000001000001
10000000000100000000001000001
100N010100010000000010000C001
10000P00000100000010E11000001
100000000001000001N1010000011
10000000000100000010001000001
1000000N000100000000001000101
10000000000100000000001000011
10000000000100000000001000001
11111111111111111111111111111